swwwwwwwwwwwwcwwwwswwwws
sTTTTTTTTTTTT.T........s
s.............T...... .s
s...........T..........s
sTTT........T..........s
sTTT.TTTTttTTTT........s
s..T ....T....TTTTTTTTTs
s..m.....T..fT....T....s
s........TTTTT....TT...s
s..f.........T.....T...s
sTTTTTTTTTTT.T.TTTTT...s
sp.....................s
ssssssssssssssssssssssss
